Command	Result
{ first }	{ first }
{ second }	{ second }
{ third }	{ third }
{ fourth }	{ fourth }
{ fifth }	{ fifth }
{ sixth }	{ sixth }
{ seventh }	{ seventh }
{ eighth }	{ eighth }
{ ninth }	{ ninth }
{ tenth }	{ tenth }
{ eleventh }	{ eleventh }
{ twelfth }	{ twelfth }
{ thirteenth }	{ thirteenth }
{ fourteenth }	{ fourteenth }
{ fifteenth }	{ fifteenth }
{ sixteenth }	{ sixteenth }
{ seventeenth }	{ seventeenth }
{ eighteenth }	{ eighteenth }
{ nineteenth }	{ nineteenth }
{ twentieth }	{ twentieth }
